а	a
б	b
в	v
г	g
д	d
е	e
ё	e
ж	zh
з	z
и	i
й	j
к	k
л	l
м	m
н	n
о	o
п	p
р	r
с	s
т	t
у	u
ф	f
х	kh
ц	ts
ч	ch
ш	sh
щ	shch
ъ	none
ы	y
ь	none
э	e
ю	yu
я	ya
